1111111111
1001000001
1001001001
1001001001
1000001001
1000001001
1101111111
1101111111
1000000001
1000000001
1001000001
1000000001
1000000001
1111111111
